Setup:
To Play this game you must first have the following installed:
Python 3.5 or higher
Pygame (if you experience intermittent fatal errors make sure you are running from the python consol or IDLE3).
This game has been tested on pygame 2.0.0dev3 and a bunch of the older versions.

You also need the following libraries:
pytmx
To install run these commands in the command prompt/terminal:
	pip install pytmx

Game Play:
Run main.py to play (open in IDLE3 [right click "open with Idle3" press F5 to run or use another IDE, or the python consol)

ï»¿Controlls:

W - forward
S - backwards
A - rotate left
D - rotate right
Z - Strafe left
C - Strafe right
arrow keys - rotate and move in NSEW directions
B - Use Equipped Item
G - throw grenade
Q - Use equipped magic
T - Transform into dragon form
R - Reload weapon
F - Breathe fire while in dragon form
E - Loot objects/Exit menus/Activate things/Talk/Mount animal/Enter vehicle
V - Climb obstacles (walls, boulders, mountains, etc.)
N - Nightmode, this is just for testing. In the future day and night will be timed.
I - To access inventory, or exit menus
K - Stats menu
P - Pause
J - Quest menu
M - toggles mini map and compass (+/- changes size of mini map)
O - toggles overworld map.
TAB - Melee attack
SPACE - Jump
LSHIFT - run
Escape - to quit  game while in  menu (currently the only way to end the game when in full screen)
ALT + ENTER - toggle fullscreen mode


Mouse:
Move Mouse - rotate/aim
Left Button - Left arm attack
Right Button - Right arm attack
Middle button - Forward (only works with some mice)

Vehicle Controlls:
E - enter vehicle
X - exit vehicle/dismount animal
Z/C - rotate turret
U - toggle mini map view in airship.

